R 1920 1080
NO ./assets/north
SO ./assets/south
WE ./assets/west
EA ./assets/east
S ./assets/sprite

F 220,100,0
C 225,30,0



11011
10001
10@01
10?01
10>01
10001
10N01
10001
11111
