R			600 400
SHADOW		8
SHADOW_FADE	4

NO			./assets/north
SO			./assets/south
WE			./assets/west
EA			./assets/east
F			./assets/floor
C			./assets/ceil

S			./assets/object
PANE		./assets/pane
DOOR_A		./assets/door_a
DOOR_B		./assets/door_b
DOOR_GRID	./assets/grid
KEY			./assets/key
TREASURE	./assets/treasure

        1111111111111111111111111
        1000000000110000000000001
        1011000001110000002000001
        1001000000000000000F00001
111111111011000001110000000000001
100000000011000001110111111111111
11110111111111011100000010001
11110111111111011101010010P01
11000000110101011100000010001
100020000000000011000000H0001
10000000000000001101010010001
11000001110101011111011110N0111
11110111 1110101 1$11330#0001
11111111 1111111 133331111111
                 111111
