R	640 400 
NO	./assets/test.xpm
SO	./assets/test.xpm
WE	./assets/test.xpm
EA ./assets/test.xpm
S ./assets/test.xpm

F 220,100,0
C 0,30,255

11111
10001
10E11
10001
11111
